1111111111111111
1000000000000001
1111111PEC111111
1111111111111111
