111111111111111111111111111111111
111111111111111111111111111111111
10000000000000000000E001111111111
1111111PEC00000CCCCCCCCC000001111
111111111111111111111111111111111
111111111111111111111111111111111