111111111111111111111111111111111
11P0001000000000000000000011CCC11
110000000000111CCCC11000000000011
110011111111111111111111111110E11
11CCCCCCCCCCCCCCCCCCCCCCCCCCCCC11
111111111111111111111111111111111