111111111111111111111111111111111
11P0001000000001111000000011CCC11
110000000000111111111000000000011
110011111111111111111111111110E11
11000000000000000000000CCC0000011
111111111111111111111111111111111